{
  "fields" : [
    [2, 2, 1, 2, 2, 2, 2, 2, 2, 2 ],
    [2, 2, 1, 2, 2, 2, 2, 2, 2, 2 ],
    [2, 2, 1, 1, 1, 2, 2, 5, 2, 2 ],
    [2, 2, 2, 2, 1, 2, 2, 1, 2, 2 ],
    [2, 2, 2, 2, 1, 2, 2, 1, 2, 2 ],
    [2, 2, 1, 1, 1, 1, 1, 1, 1, 2 ],
    [2, 2, 1, 2, 2, 2, 2, 2, 1, 2 ],
    [2, 2, 1, 2, 2, 2, 2, 2, 1, 2 ],
    [2, 2, 5, 2, 2, 5, 1, 1, 1, 2 ],
    [2, 2, 2, 2, 2, 2, 2, 2, 2, 2 ]
  ],
  "creatures" : [
    [0, 2, 4], [1, 6, 2], [0, 5, 7]
  ],
  "transitions" : [
    ["greenland", "Greenland", 0, 2]
  ]
}