{
  "fields" : [
    [2, 2, 2, 2, 2, 2, 2, 2, 2, 2 ],
    [2, 0, 0, 0, 0, 0, 0, 0, 0, 0 ],
    [1, 1, 1, 1, 1, 0, 3, 0, 0, 0 ],
    [2, 0, 4, 0, 1, 0, 0, 0, 3, 0 ],
    [2, 0, 3, 0, 1, 0, 0, 0, 0, 0 ],
    [2, 0, 0, 0, 1, 1, 1, 1, 1, 1 ],
    [2, 0, 0, 0, 0, 0, 0, 0, 0, 0 ],
    [2, 0, 3, 0, 0, 0, 3, 0, 0, 0 ],
    [2, 0, 0, 0, 3, 0, 0, 0, 3, 0 ],
    [2, 0, 0, 0, 0, 0, 0, 0, 0, 0 ]
  ],
  "creatures" : [
    [0, 6, 3], [0, 2, 8], [0, 8, 5]
  ]
}