{
  "fields" : [
    [0, 0, 0, 0, 1, 0, 0, 0, 0, 0 ],
    [0, 3, 0, 0, 1, 0, 0, 3, 0, 0 ],
    [0, 0, 0, 0, 1, 0, 0, 0, 0, 0 ],
    [0, 0, 3, 0, 1, 0, 3, 0, 3, 0 ],
    [0, 0, 0, 0, 1, 0, 0, 0, 0, 0 ],
    [0, 0, 0, 0, 1, 1, 1, 0, 0, 0 ],
    [0, 3, 0, 0, 0, 4, 1, 0, 3, 0 ],
    [0, 0, 0, 0, 3, 0, 1, 0, 0, 0 ],
    [0, 0, 0, 3, 0, 0, 1, 0, 3, 0 ],
    [0, 0, 0, 0, 0, 0, 1, 0, 0, 0 ]
  ],
  "creatures" : [
    [0, 2, 3], [1, 2, 7], [0, 7, 2]
  ],
  "transitions" : []
}