{
  "fields" : [
    [2, 0, 0, 0, 0, 0, 0, 0, 0, 0 ],
    [2, 0, 3, 0, 0, 3, 0, 0, 0, 0 ],
    [2, 0, 0, 0, 0, 0, 0, 0, 0, 0 ],
    [2, 0, 0, 0, 0, 0, 0, 3, 0, 0 ],
    [2, 0, 3, 0, 0, 0, 0, 0, 0, 0 ],
    [2, 0, 0, 0, 3, 0, 0, 0, 0, 0 ],
    [2, 0, 0, 0, 0, 0, 0, 3, 0, 0 ],
    [2, 0, 3, 0, 0, 0, 0, 0, 0, 0 ],
    [2, 0, 0, 0, 4, 0, 0, 0, 0, 0 ],
    [2, 2, 2, 2, 2, 2, 2, 2, 2, 2 ]
  ],
  "creatures" : [
    [0, 3, 3], [1, 4, 7], [0, 8, 3]
  ],
  "transitions" : []
}