{
  "fields" : [
    [0, 0, 0, 0, 0, 0, 1, 0, 0, 2 ],
    [0, 3, 0, 3, 0, 0, 1, 0, 0, 2 ],
    [0, 0, 0, 0, 0, 0, 1, 0, 0, 2 ],
    [0, 0, 3, 0, 3, 0, 1, 0, 3, 2 ],
    [0, 0, 0, 0, 0, 0, 1, 4, 0, 2 ],
    [0, 0, 0, 0, 1, 1, 1, 0, 0, 2 ],
    [0, 3, 0, 3, 1, 0, 0, 0, 0, 2 ],
    [0, 0, 0, 0, 1, 0, 3, 0, 0, 2 ],
    [0, 0, 3, 0, 1, 0, 0, 0, 3, 2 ],
    [0, 0, 0, 0, 1, 0, 0, 0, 0, 2 ]
  ],
  "creatures" : [
    [0, 2, 3], [0, 7, 7], [0, 7, 1]
  ],
  "transitions" : []
}