{
  "fields" : [
    [2, 0, 0, 0, 0, 0, 0, 0, 0, 0 ],
    [2, 0, 0, 0, 0, 0, 0, 0, 0, 0 ],
    [2, 0, 3, 0, 0, 0, 0, 0, 3, 0 ],
    [2, 0, 0, 0, 0, 3, 0, 0, 0, 0 ],
    [2, 0, 0, 0, 0, 0, 0, 0, 0, 0 ],
    [2, 0, 3, 0, 0, 0, 0, 0, 3, 0 ],
    [2, 0, 0, 4, 0, 0, 3, 0, 0, 0 ],
    [2, 0, 0, 0, 0, 6, 0, 0, 0, 0 ],
    [2, 0, 0, 3, 0, 0, 0, 0, 3, 0 ],
    [2, 0, 0, 0, 0, 0, 0, 0, 0, 0 ]
  ],
  "creatures" : [
    [0, 3, 3], [1, 8, 2], [0, 5, 7]
  ],
  "transitions" : [
    ["greenland_caveofdust", "Cave of dust", 7, 5]
  ]
}