{
  "fields" : [
    [2, 2, 2, 2, 2, 2, 2, 2, 2, 2 ],
    [0, 0, 0, 0, 0, 0, 0, 0, 0, 2 ],
    [0, 3, 0, 0, 0, 0, 1, 1, 1, 1 ],
    [0, 0, 0, 3, 0, 0, 1, 0, 0, 2 ],
    [0, 0, 0, 0, 0, 0, 1, 4, 3, 2 ],
    [1, 1, 1, 1, 1, 1, 1, 0, 0, 2 ],
    [0, 0, 0, 0, 0, 0, 1, 0, 0, 2 ],
    [0, 0, 3, 0, 0, 0, 1, 0, 0, 2 ],
    [0, 0, 0, 0, 3, 4, 1, 0, 3, 2 ],
    [0, 0, 0, 0, 0, 0, 1, 0, 0, 2 ]
  ],
  "creatures" : [
    [0, 2, 4], [0, 7, 8], [0, 8, 2]
  ],
  "transitions" : []
}