{
  "fields" : [
    [2, 0, 0, 0, 0, 0, 0, 0, 0, 0 ],
    [2, 0, 0, 0, 0, 0, 0, 0, 0, 0 ],
    [2, 0, 3, 0, 0, 0, 0, 0, 3, 0 ],
    [2, 0, 0, 0, 0, 3, 0, 0, 0, 0 ],
    [2, 0, 0, 0, 0, 0, 0, 0, 0, 0 ],
    [2, 0, 3, 0, 0, 0, 0, 0, 3, 0 ],
    [2, 0, 0, 4, 0, 0, 3, 0, 0, 0 ],
    [2, 0, 0, 0, 0, 5, 0, 0, 0, 0 ],
    [2, 0, 0, 3, 0, 0, 0, 0, 3, 0 ],
    [2, 0, 0, 0, 0, 0, 0, 0, 0, 0 ]
  ],
  "creatures" : [
    [0, 3, 3], [0, 8, 2], [0, 5, 7]
  ],
  "transitions" : [
    ["cave1", "Cave of dust", 7, 5]
  ]
}