{
  "fields" : [
    [2, 2, 2, 2, 2, 2, 2, 2, 2, 2 ],
    [2, 2, 1, 1, 1, 1, 1, 2, 2, 2 ],
    [2, 2, 1, 2, 2, 2, 1, 2, 5, 2 ],
    [2, 2, 1, 2, 2, 2, 1, 2, 1, 2 ],
    [1, 1, 1, 2, 2, 2, 1, 1, 1, 2 ],
    [2, 2, 2, 2, 2, 2, 2, 2, 1, 2 ],
    [2, 2, 2, 2, 1, 1, 5, 2, 1, 2 ],
    [2, 2, 2, 2, 1, 2, 2, 2, 1, 2 ],
    [2, 2, 2, 2, 1, 1, 1, 1, 1, 2 ],
    [2, 2, 2, 2, 2, 2, 2, 2, 2, 2 ]
  ],
  "creatures" : [
    [0, 1, 2], [1, 4, 8], [0, 7, 4]
  ],
  "transitions" : [
    ["greenland", "Greenland", 4, 0]
  ]
}